16,16,16,16,16,16,16,16,16,16,16,16,16,16,16,16,16,16,16,16,16,16,16,16,16,16,16,16,16,16,
16,16,16,16,16,16,16,16,16,16,16,16,16,16,16,16,16,16,16,16,16,16,16,16,16,16,16,16,16,16,
16,16,16,16,16,16,16,16,16,16,16,16,16,16,16,16,16,16,16,16,16,16,16,16,16,16,16,16,16,16,
16,16,16,16,16,16,16,16,16,16,16,16,16,16,16,16,16,16,16,16,16,16,16,16,16,16,16,16,16,16,
16,16,16,16,16,16,16,16,16,16,16,16,16,16,16,16,16,16,16,16,16,16,16,16,16,16,16,16,16,16,
16,16,16,16,16,16,16,16,16,16,16,16,16,16,16,16,16,16,16,16,16,16,16,16,16,16,16,16,16,16,
16,16,14,15,16,16,16,16,16,16,16,16,16,16,16,16,16,16,16,16,16,16,16,16,16,16,16,16,16,16,
16,16,12,13,16,16,16,16,16,11,11,16,16,16,16,16,16,16,16,16,16,19,17,16,16,16,16,16,16,16,
16,16,16,16,16,16,16,16,16,16,16,16,16,16,16,16,16,16,16,16,16,16,16,16,16,16,16,16,16,16,
16,16,16,16,16,16,16,16,16,16,16,16,16,16,16,16,16,14,15,16,16,17,19,17,16,16,16,16,16,16,
16,16,16,16,16,16,16,16,16,16,16,16,16,16,16,16,16,12,13,16,16,16,16,16,16,16,16,16,16,16,
16,16,16,16,16,16,16,16,16,19,16,16,16,16,16,16,16,14,15,16,16,16,16,16,16,16,16,16,16,16,
16,16,16,16,16,16,16,17,16,17,16,16,16,16,16,16,16,16,16,16,16,16,16,16,16,16,16,16,16,16,
16,16,16,16,16,16,16,16,16,17,16,16,16,16,16,16,16,16,16,16,16,16,16,16,16,16,16,16,16,16,
16,16,16,16,16,16,16,16,16,16,16,16,16,16,16,16,16,12,13,16,16,16,16,16,16,16,16,16,16,16,
16,16,16,16,16,16,16,16,16,16,16,16,16,16,16,16,16,14,15,16,16,16,16,16,16,16,16,16,16,16,
16,16,16,16,16,16,16,16,16,16,16,16,16,16,16,16,16,16,16,16,16,16,16,16,16,16,16,16,16,16,
16,16,16,16,16,16,16,16,16,16,16,16,16,16,16,16,16,14,15,16,16,16,16,16,16,16,16,16,16,16,
16,16,16,16,16,16,16,16,16,16,16,16,16,16,16,16,16,12,13,16,16,16,16,16,16,16,16,16,16,16,
16,16,16,16,16,16,16,16,16,16,16,16,16,16,16,16,16,14,15,16,16,16,16,16,16,16,16,16,16,16,
16,16,16,16,16,16,16,16,16,16,16,16,16,16,16,16,16,16,16,16,16,16,16,16,16,16,16,16,16,16,
16,16,16,16,16,16,11,11,11,16,16,16,16,16,16,16,16,16,16,16,16,16,16,16,16,16,16,16,16,16,
16,11,11,11,11,16,16,16,16,16,11,16,11,11,11,16,16,16,16,11,11,11,16,11,11,11,11,11,16,16,
16,16,16,16,16,16,16,16,16,16,16,16,16,16,14,15,16,16,16,16,16,16,16,16,16,16,16,16,16,16,
16,16,16,16,16,16,16,17,16,19,16,16,16,16,12,13,16,16,16,16,16,16,16,16,16,16,16,16,16,16,
16,16,16,16,16,16,16,17,16,17,16,16,16,16,16,16,16,16,16,16,16,16,16,16,16,16,16,16,16,16,
16,16,16,16,16,16,16,16,16,16,16,16,16,16,12,13,16,16,16,16,16,16,16,16,16,16,16,16,16,16,
16,16,16,16,16,16,16,16,16,16,16,16,16,16,14,15,16,16,16,16,16,16,16,16,16,16,16,16,16,16,
16,16,16,16,16,16,16,16,16,16,16,16,16,16,12,13,16,16,16,16,16,16,16,16,16,16,16,16,16,16,
16,16,16,16,16,16,16,16,16,16,16,16,16,16,16,16,16,16,16,16,16,16,16,16,16,16,16,16,16,16,
2,2,1,2,6,2,1,2,2,2,1,2,6,2,1,2,1,2,1,2,1,2,1,2,1,2,1,2,1,2,
1,0,0,0,0,0,0,0,1,0,0,0,0,0,0,0,1,0,0,0,0,0,0,2,0,0,0,0,0,2,
2,0,0,0,0,0,0,0,2,0,0,0,0,0,0,0,2,0,0,0,0,0,0,1,0,0,0,0,0,1,
6,0,0,0,0,0,0,0,1,0,0,0,0,0,0,0,1,0,0,0,0,0,0,2,0,0,0,0,0,8,
2,0,0,0,0,0,0,0,2,0,0,0,0,0,0,0,2,0,0,0,0,0,0,0,0,0,0,0,0,7,
2,1,2,1,0,1,2,1,2,1,2,1,0,1,2,1,2,0,0,0,0,0,0,2,0,0,0,0,0,9,
2,0,0,0,0,0,0,0,0,0,0,0,0,0,0,0,0,0,0,0,0,0,0,1,0,0,0,0,0,6,
1,0,0,0,0,0,0,0,0,0,0,0,0,0,0,0,0,0,0,0,0,0,0,2,0,0,0,0,0,2,
2,0,1,2,6,2,1,2,1,2,1,2,1,2,1,2,1,0,0,2,1,4,3,5,1,2,1,2,1,2,
1,0,0,0,0,0,0,0,1,0,0,0,0,0,0,0,2,0,0,2,0,0,0,0,1,0,0,0,0,2,
2,0,0,0,0,0,0,0,2,0,0,0,0,0,0,0,1,0,0,1,0,0,0,0,2,0,0,0,0,1,
1,0,0,0,0,0,0,0,6,0,0,0,0,0,0,0,2,0,0,2,0,0,0,0,1,0,0,0,0,2,
2,0,0,0,0,0,0,0,4,0,0,0,0,0,0,0,1,0,0,0,0,0,0,0,0,0,0,0,0,1,
1,0,0,0,0,0,0,0,6,0,0,0,0,0,0,0,2,0,0,2,0,0,0,0,1,0,0,0,0,2,
2,0,0,0,0,0,0,0,2,0,0,0,0,0,0,0,1,0,0,1,0,0,0,0,2,0,0,0,0,1,
1,0,0,0,0,0,0,0,1,0,0,0,0,0,0,0,2,0,0,2,0,0,0,0,1,0,0,0,0,2,
2,2,1,2,1,2,1,2,2,1,2,1,2,1,0,1,2,0,0,2,1,2,1,2,1,2,1,2,1,2,
1,0,0,0,0,0,0,0,1,0,0,0,0,0,0,0,2,0,0,2,0,0,0,0,0,0,0,0,0,2,
2,0,0,0,0,0,0,0,2,0,0,0,0,0,0,0,1,0,0,1,0,0,0,0,0,0,0,0,0,1,
1,0,0,0,0,0,0,0,1,0,0,0,0,0,0,0,2,0,0,2,0,0,0,0,0,0,0,0,0,2,
2,2,1,2,0,2,1,2,1,2,1,0,1,2,1,2,1,0,0,1,2,1,2,1,0,1,2,1,2,2,
1,0,0,0,0,0,0,0,0,0,0,0,0,0,0,0,0,0,0,0,0,0,0,0,0,0,0,0,0,6,
2,0,0,0,0,0,0,0,0,0,0,0,0,0,0,0,0,0,0,0,0,0,0,0,0,0,0,0,0,2,
2,1,2,1,0,1,2,1,2,3,2,1,2,1,0,0,1,2,1,2,1,2,1,2,0,2,1,2,1,2,
2,0,0,0,0,0,0,0,5,0,0,0,0,0,0,0,2,0,0,0,0,2,0,0,0,0,0,0,0,2,
1,0,0,0,0,0,0,0,3,0,0,0,0,2,0,0,6,0,0,0,0,1,0,0,0,0,0,0,0,1,
2,0,0,0,0,0,0,0,2,0,0,0,0,1,0,0,2,0,0,0,0,2,0,0,0,0,0,0,0,2,
1,0,0,0,0,0,0,0,6,0,0,0,0,2,0,0,0,0,0,0,0,1,0,0,0,0,0,0,0,1,
2,0,0,0,0,0,0,0,2,0,0,0,0,1,0,0,2,0,0,0,0,2,0,0,0,0,0,0,0,2,
2,1,2,1,2,1,2,1,2,1,2,1,2,2,2,2,2,2,2,2,2,2,1,2,1,2,6,2,1,2,
20,19,20,19,19,19,20,19,19,19,19,19,20,20,19,19,19,20,19,19,20,19,20,19,20,20,20,19,19,19,
19,19,20,19,19,19,19,19,19,19,19,19,19,19,19,19,19,19,20,20,19,19,20,20,20,19,19,19,19,19,
19,20,19,19,19,19,19,19,19,19,19,19,20,19,19,19,19,19,20,20,19,20,20,20,19,19,20,20,19,19,
20,19,19,19,19,20,19,19,19,19,19,19,19,19,19,19,19,19,19,19,20,19,20,20,19,19,19,19,19,19,
20,19,19,19,20,19,19,20,19,19,19,19,19,20,19,20,20,20,19,19,19,19,19,19,20,19,20,19,19,19,
19,19,19,19,20,20,19,20,19,19,19,20,20,19,19,19,19,19,19,19,19,19,20,19,19,19,19,20,20,19,
19,20,19,20,19,20,19,19,19,20,19,19,19,19,19,20,19,19,19,20,19,19,19,20,19,19,20,19,19,19,
19,20,19,19,19,19,19,20,19,19,19,19,20,19,19,20,19,20,19,20,19,19,20,19,20,19,19,19,19,19,
20,19,20,19,19,19,19,19,19,19,20,20,19,19,19,19,19,19,19,19,19,19,19,19,19,19,19,19,19,19,
19,20,19,19,19,19,19,19,19,20,19,19,19,20,19,19,19,19,19,19,19,20,19,19,19,19,19,19,19,19,
19,20,20,19,19,19,19,19,19,20,19,19,19,19,19,19,20,19,20,19,20,19,19,19,19,20,19,19,19,19,
20,19,20,19,20,20,19,20,20,19,19,20,20,20,20,20,19,19,20,20,19,19,19,20,20,19,19,20,19,19,
19,19,19,19,19,19,19,19,19,19,19,19,20,19,19,19,19,19,20,19,19,19,20,19,19,19,19,19,19,20,
19,19,19,19,19,19,19,19,19,20,19,19,19,19,19,19,19,19,19,19,19,19,19,19,19,19,19,20,20,20,
19,20,19,19,19,19,19,19,20,19,19,19,19,19,19,19,19,20,19,19,20,19,19,20,19,19,19,19,19,19,
19,19,19,19,19,19,20,19,19,19,19,19,19,19,19,19,19,19,20,19,19,19,19,19,19,19,19,19,19,19,
20,19,20,19,19,19,19,19,20,19,19,19,19,20,20,19,19,19,19,20,20,19,19,20,19,19,20,19,20,20,
19,20,19,19,19,20,19,19,20,19,20,20,19,19,19,19,19,19,19,19,20,19,19,19,19,19,19,19,19,19,
19,20,20,20,19,19,20,19,19,19,19,20,19,19,19,19,19,19,19,19,19,19,19,19,19,19,20,19,19,20,
19,19,19,19,19,19,19,20,19,19,19,19,19,19,19,20,20,19,20,19,20,19,19,20,19,19,19,19,19,19,
20,20,19,19,19,19,19,20,19,20,19,19,20,19,19,19,19,19,19,19,20,19,19,19,20,19,19,19,19,19,
19,19,19,19,20,20,19,19,19,19,19,19,20,20,19,20,19,19,19,19,20,20,19,20,20,19,20,19,19,19,
20,19,19,19,19,19,19,20,19,20,19,19,19,19,20,19,19,20,20,19,19,20,19,19,19,19,19,20,19,19,
19,19,19,19,20,20,19,19,19,19,19,19,19,20,19,19,19,19,19,19,20,19,19,19,19,19,19,19,19,20,
19,19,19,20,19,19,20,20,19,19,19,19,20,19,20,19,19,19,20,19,19,20,19,19,19,19,19,19,19,19,
19,19,19,19,19,19,20,20,19,19,19,19,19,19,19,19,20,19,19,19,19,20,20,19,20,19,20,19,19,20,
19,19,19,19,19,19,19,19,19,19,19,19,20,19,19,19,19,19,19,20,19,19,19,19,20,19,20,20,19,19,
19,19,19,19,19,20,19,19,19,19,20,19,19,19,19,19,19,19,19,19,20,20,19,20,19,19,20,19,19,19,
19,19,20,20,20,19,19,19,20,19,19,19,19,19,20,19,19,20,19,19,19,19,20,20,19,19,19,19,20,19,
19,20,19,20,19,19,19,19,19,19,20,19,19,20,19,19,20,19,19,19,20,19,19,19,19,19,19,19,20,19
